############
#O         #
#       P  #
#          #
#   X      #
#####      #
#        X #
#          #
#  O    ####
#        X #
###        #
#O         #
############
